############
#          #
#          #
# Pa     O#
#          #
#          #		
############