###############
#   O          #
#   a         #
#O  a  P     #
#             #
###############