###############
#   O         #
#   a    a     #
#O   a  P  a  O #
#        O     #
###############